111111111
100000001
100011111
110001111
111101001
101000001
101000001
100000001
111111111
