!!!!!!!!!!
!********!
!*!*!*!*!!
!*!*!*!*!!
!*!**!***!
!**!*!!!*!
!!@!!!#**!
!!!!!!!!!!