!!!!!!!!!!!!!!!!!!
!!*******!#!!!***!
!!*!!!!!*!*!!!*!*!
!!*!!!!!*!*!!!*!*!
!!*!!****!*****!*!
!!*!!*!!!!!!!!!!*!
!!@!!************!
!!!!!!!!!!!!!!!!!!