!!!!!!!!!!!!!!!!!!
!**********!*****!
!*!*!!!*!!*!*!*!*!
!*!!!!!*!!*!*!*!*!
!*!!*!***!*!*!!#*!
!**!@!!!!!*!**!!!!
!!***!!*******!!!!
!!!!!!!!!!!!!!!!!!